9 12 9 12 9 12 9 12 13 13 9 8 14 9 10 12 
5 5 5 1 4 1 4 1 0 0 6 1 12 3 12 5 
5 5 5 7 3 6 3 6 7 5 9 4 1 12 5 5 
5 5 5 13 9 12 13 9 12 3 6 3 4 5 5 5 
5 5 5 1 6 3 4 5 5 9 10 12 3 4 5 5 
5 5 5 1 10 12 3 6 3 6 9 2 10 6 5 5 
5 5 5 7 9 2 12 9 10 12 3 10 12 9 6 5 
5 5 5 13 3 8 6 1 12 1 10 10 6 3 12 5 
5 5 1 4 9 2 14 1 6 5 9 12 9 12 5 5 
5 5 5 5 3 12 13 3 10 2 6 3 6 3 6 5 
5 1 6 1 12 3 0 14 9 12 9 12 9 12 9 6 
5 5 9 6 3 10 2 14 5 1 6 3 4 5 3 12 
5 3 6 9 12 9 12 13 1 2 14 11 2 4 13 5 
5 13 13 5 5 5 5 1 0 12 9 12 9 2 4 5 
1 0 0 0 0 0 0 4 5 1 4 1 4 9 4 5 
7 7 7 7 7 7 7 3 2 6 3 6 3 6 3 6 
