11 12 9 10 12 9 12 9 10 10 10 10 8 10 12 13 
9 2 4 11 0 4 1 6 13 9 10 8 6 13 5 5 
5 9 2 8 6 1 2 8 2 0 10 0 10 0 6 5 
5 1 10 4 9 4 9 6 9 0 12 1 12 3 10 4 
5 3 8 6 5 3 6 9 6 7 5 5 3 8 14 5 
5 9 2 8 2 10 8 0 10 10 4 3 12 5 11 4 
5 3 12 5 13 13 5 3 10 12 3 12 5 3 10 4 
5 13 5 1 2 4 5 9 12 1 14 3 2 8 10 6 
5 5 3 2 12 7 5 3 4 5 9 10 12 1 10 12 
1 2 10 14 5 11 2 12 3 4 1 12 3 4 13 5 
1 10 8 14 3 12 11 2 10 4 5 7 9 2 6 5 
1 12 3 10 14 5 9 10 12 7 5 11 4 13 11 4 
5 1 10 14 11 4 5 11 2 8 4 11 4 1 12 5 
5 5 9 12 9 0 6 9 10 4 1 8 4 5 5 5 
1 2 4 1 6 1 8 4 13 5 7 5 5 5 5 7 
7 15 7 3 10 6 7 3 2 2 14 3 2 2 2 14 
