9 10 10 10 10 10 10 10 10 10 10 10 8 10 8 14 
1 12 9 10 10 10 10 10 10 10 12 11 2 10 0 12 
5 5 1 10 10 10 10 10 10 10 2 10 10 12 5 5 
5 5 1 12 13 9 10 10 10 10 10 8 12 5 5 5 
5 5 5 5 5 5 9 8 10 10 12 5 5 5 1 4 
1 6 1 0 4 5 5 1 10 10 0 2 6 1 6 5 
5 13 5 5 5 5 5 3 10 8 4 9 10 6 13 5 
5 5 5 5 5 5 5 9 12 5 5 1 12 13 5 5 
5 5 1 2 2 6 5 3 4 3 6 5 1 4 5 7 
5 5 7 9 10 12 1 10 2 10 12 5 5 3 4 13 
5 5 13 5 9 4 3 8 10 8 6 3 2 12 1 4 
5 1 4 1 6 5 11 2 8 6 9 10 10 2 6 5 
3 6 3 6 9 6 11 8 6 11 2 10 10 8 14 5 
9 10 10 8 2 12 11 2 8 10 10 12 11 2 8 4 
5 9 10 2 10 2 10 12 1 10 10 2 10 10 6 5 
7 3 10 10 10 10 10 6 3 10 10 10 10 10 10 6 
