11 10 10 10 10 8 10 10 10 12 9 10 8 10 10 12 
9 10 10 10 10 6 11 10 14 5 7 15 5 13 13 5 
5 9 10 10 8 10 10 10 10 2 10 10 6 5 7 5 
5 5 9 12 5 9 10 10 10 12 9 10 10 4 9 6 
5 5 3 6 5 5 11 10 14 5 5 13 13 5 5 13 
5 5 11 10 6 3 10 10 10 6 5 5 5 5 5 5 
5 3 10 10 10 10 8 10 10 8 4 5 5 1 6 5 
3 10 10 8 10 14 5 9 12 5 5 5 5 5 13 5 
13 11 14 5 9 10 6 3 4 5 5 5 5 5 5 5 
1 10 10 6 5 11 10 10 2 6 7 5 7 5 7 5 
5 9 10 10 2 10 10 10 12 9 10 2 10 2 10 4 
5 5 11 10 10 10 10 14 5 5 11 10 10 10 14 5 
5 3 10 10 10 8 10 10 2 4 11 10 10 10 10 6 
5 11 10 10 14 7 11 10 14 3 10 10 10 10 10 12 
1 10 10 8 10 10 10 10 10 10 10 10 10 12 15 5 
7 11 14 3 10 10 10 10 14 11 10 10 10 2 10 6 
