9 10 8 10 10 14 9 10 8 10 8 10 10 10 10 12 
5 15 3 10 8 10 6 15 5 15 5 11 10 10 14 5 
1 10 10 8 6 9 10 10 2 10 2 10 10 8 10 4 
5 9 12 5 13 1 10 14 15 11 8 10 10 4 13 5 
5 5 5 5 5 5 9 10 10 12 5 13 15 5 7 5 
5 5 5 7 1 4 5 11 14 5 5 1 10 2 10 4 
5 5 3 12 5 5 3 10 10 6 5 5 11 10 12 5 
1 2 12 5 5 3 10 8 12 11 6 1 10 12 5 5 
7 15 5 5 1 10 12 3 2 10 10 6 13 5 5 5 
9 10 4 5 5 15 3 10 10 10 10 10 4 5 5 5 
5 15 7 5 3 10 10 10 10 10 10 10 4 5 3 4 
1 10 12 1 10 8 10 10 10 10 10 12 5 1 12 5 
5 13 5 5 15 3 10 10 10 10 10 4 5 5 5 5 
5 5 5 1 8 10 8 10 8 12 15 5 3 6 5 5 
5 7 5 7 5 15 5 15 5 3 10 2 10 10 6 5 
7 11 2 10 2 14 3 10 2 10 10 10 10 10 10 6 
