13 9 10 10 10 10 10 10 10 8 10 10 8 10 10 12 
5 5 11 10 10 10 10 8 10 2 10 8 2 10 12 5 
1 6 9 10 10 10 10 2 10 10 12 3 10 12 5 5 
1 12 5 9 10 10 10 10 10 10 2 10 14 5 5 5 
5 5 5 5 9 10 10 14 11 10 10 12 13 5 5 5 
5 5 5 5 5 9 10 14 11 10 12 5 5 5 5 5 
5 5 5 5 5 5 9 10 10 12 5 1 4 5 5 5 
5 5 5 5 5 5 5 9 12 5 5 5 5 5 5 5 
5 5 1 0 0 0 0 2 6 5 1 4 5 5 5 5 
5 5 5 5 5 5 3 10 8 6 5 5 5 1 4 5 
5 5 5 5 7 7 11 10 2 10 6 5 5 5 5 5 
5 5 5 5 11 10 10 10 8 10 10 6 5 5 1 4 
1 6 5 3 10 10 10 10 2 10 10 10 6 5 5 5 
1 12 3 10 10 10 10 10 8 10 10 10 14 7 7 5 
5 5 11 10 8 10 10 14 3 10 10 10 10 10 10 4 
7 3 10 10 2 10 10 10 10 10 10 10 10 10 10 6 
