13 9 10 8 10 8 14 9 10 10 10 10 10 8 8 12 
5 1 12 1 10 0 14 3 10 10 10 10 12 5 5 5 
5 5 5 3 10 2 10 10 10 10 10 10 6 1 6 5 
1 4 5 9 10 8 10 8 10 10 10 10 12 5 9 6 
5 5 5 1 10 0 10 0 14 9 8 8 6 5 5 13 
5 5 5 1 10 0 10 2 14 5 5 5 13 5 3 4 
1 4 5 3 10 4 9 10 12 5 5 5 5 5 13 5 
5 5 1 14 11 0 4 9 4 1 0 0 4 5 1 4 
5 5 3 8 14 7 5 3 6 5 5 5 5 5 5 5 
1 4 9 2 8 14 7 9 10 4 5 5 5 5 5 5 
5 5 1 8 2 12 13 3 10 2 2 2 4 5 1 4 
5 5 7 3 12 1 4 9 12 9 12 13 5 5 5 5 
5 3 10 12 3 4 1 4 1 4 1 0 6 5 5 5 
1 10 12 5 11 2 6 3 6 3 6 3 10 6 3 4 
5 13 5 3 10 10 8 10 10 8 10 10 10 10 8 4 
7 3 2 10 10 10 2 10 10 2 10 10 10 10 6 7 
