9 8 10 8 10 10 10 12 9 10 10 12 9 8 10 12 
5 5 13 5 11 10 10 4 1 8 12 1 4 5 11 4 
5 5 5 1 10 10 10 4 5 5 5 5 5 3 10 6 
5 7 5 5 11 10 10 4 3 6 5 5 3 10 10 12 
1 10 2 2 10 10 14 3 10 10 6 3 10 10 10 4 
5 11 10 10 12 9 10 8 10 10 12 9 10 10 12 5 
1 8 10 12 5 5 9 0 10 12 5 5 9 14 5 5 
5 5 13 5 5 5 5 1 12 5 5 5 3 10 6 5 
5 7 5 7 5 5 5 3 6 5 5 3 10 10 10 4 
3 10 2 8 6 3 2 10 10 2 2 10 12 9 12 5 
9 10 10 0 10 14 11 10 8 10 10 8 6 5 5 5 
5 9 10 0 8 10 8 12 5 11 10 2 10 2 0 4 
5 5 13 5 5 13 5 5 1 10 10 10 10 14 5 5 
5 5 5 5 5 5 5 5 1 10 10 10 10 10 4 5 
5 5 5 7 5 5 7 5 5 11 10 10 10 10 6 5 
7 3 2 10 2 2 10 6 3 10 10 10 10 10 10 6 
