9 10 10 10 10 10 10 10 10 10 10 10 10 10 10 12 
5 9 10 10 10 10 8 8 10 10 10 10 10 10 12 5 
5 5 9 10 10 12 5 1 10 10 8 10 10 12 5 5 
5 5 5 9 12 5 5 5 11 10 2 10 12 5 1 6 
5 5 5 5 5 5 5 3 10 10 10 8 6 5 5 13 
5 5 5 5 5 5 5 9 10 10 12 3 10 4 5 5 
5 5 5 5 5 5 1 6 9 8 2 10 12 3 6 5 
5 5 5 5 5 5 5 9 4 5 9 12 5 11 8 6 
5 3 2 6 5 5 5 3 6 5 5 5 3 12 3 12 
5 9 8 14 5 5 3 10 10 6 3 2 12 5 9 6 
5 5 3 10 6 5 9 10 10 8 10 8 6 5 3 12 
5 1 12 9 10 6 3 10 10 2 8 2 8 2 8 6 
3 4 1 6 9 10 10 10 10 12 3 8 2 8 2 12 
9 4 5 9 6 9 10 10 12 3 12 3 8 2 8 6 
5 5 1 6 11 2 12 9 2 14 3 12 3 10 2 12 
7 3 2 10 10 10 6 3 10 10 10 2 10 10 10 6 
