9 10 10 10 10 10 10 8 10 8 8 12 9 8 8 12 
5 11 8 8 8 12 13 5 11 4 5 5 7 5 5 5 
5 13 5 5 5 5 5 5 11 6 7 1 10 6 7 5 
5 5 5 5 5 5 5 1 10 10 10 0 10 10 12 5 
5 1 4 5 5 5 5 5 11 10 10 0 10 10 4 5 
5 5 5 1 0 0 4 5 9 10 10 0 10 10 4 5 
5 7 5 5 5 5 5 7 3 10 10 2 10 10 6 5 
1 10 0 4 5 5 5 9 12 11 10 10 10 10 12 5 
5 13 5 5 5 5 5 1 6 11 10 10 10 10 2 4 
5 5 5 5 5 5 5 5 11 10 10 8 10 10 12 5 
5 5 5 1 0 0 4 5 11 10 10 0 10 10 4 5 
5 1 4 5 5 5 5 5 11 10 10 0 10 10 0 4 
5 5 5 5 5 5 1 4 9 10 10 0 10 10 6 5 
5 7 5 5 5 5 5 1 0 14 13 1 10 12 13 5 
5 9 2 2 2 6 7 7 3 14 5 7 13 5 5 5 
7 3 10 10 10 10 10 10 10 10 2 10 2 2 2 6 
