9 10 10 10 10 10 10 8 10 10 10 10 10 10 10 12 
5 9 10 10 10 10 10 2 10 10 10 10 10 8 12 5 
5 5 9 10 10 10 10 10 10 10 8 10 10 4 5 5 
5 5 5 9 10 10 10 10 10 10 2 10 12 5 5 5 
5 5 5 5 9 10 10 10 10 10 10 12 5 5 5 5 
5 5 5 5 5 9 10 10 8 10 12 5 5 5 5 5 
5 5 5 5 5 5 9 10 2 12 5 5 5 5 5 5 
1 4 5 5 5 5 5 9 12 5 5 5 5 1 0 4 
5 5 5 1 4 5 5 1 6 5 5 5 5 5 5 5 
5 5 5 5 5 5 5 3 10 6 1 4 5 5 5 5 
5 5 5 5 5 5 3 10 10 10 6 5 5 5 5 5 
5 5 5 5 5 3 10 10 8 10 10 6 5 5 5 5 
5 5 5 5 3 10 10 10 2 10 10 10 6 5 5 5 
5 5 5 3 10 10 10 10 10 10 10 10 10 6 5 5 
1 4 3 10 10 10 10 10 8 10 10 10 10 10 6 5 
7 3 10 10 10 10 10 10 2 10 10 10 10 10 10 6 
