9 10 10 10 10 10 10 12 11 8 8 12 9 8 8 12 
5 11 8 8 8 12 13 1 10 4 5 5 7 5 5 5 
5 13 5 5 5 5 5 1 10 6 7 1 10 6 7 5 
5 5 5 5 5 5 5 1 10 10 10 0 10 10 12 5 
5 1 4 5 5 5 5 1 10 10 10 0 10 10 4 5 
5 5 5 1 0 0 4 1 10 10 10 0 10 10 4 5 
5 7 5 5 5 5 5 3 10 10 10 2 10 10 6 5 
1 10 0 4 5 5 5 9 12 11 10 10 10 10 12 5 
5 13 5 5 5 5 5 1 6 11 10 10 10 10 2 4 
5 5 5 5 5 5 5 5 11 10 10 8 10 10 12 5 
5 5 5 1 0 0 4 5 11 10 10 0 10 10 4 5 
5 1 4 5 5 5 5 5 11 10 10 0 10 10 0 4 
5 5 5 5 5 5 5 5 11 8 8 0 10 10 6 5 
5 7 7 5 5 5 5 1 10 4 5 1 10 12 13 5 
5 9 10 2 2 6 7 7 11 6 7 3 12 5 5 5 
7 3 10 10 10 10 10 10 10 10 10 10 2 2 2 6 
