9 10 10 10 10 10 10 12 9 10 10 10 8 8 10 12 
5 9 8 10 10 10 10 2 2 10 10 10 4 3 12 7 
5 5 1 10 10 10 10 10 10 10 10 12 3 12 3 12 
5 5 5 9 10 10 10 10 10 10 12 3 12 3 12 5 
5 5 5 5 9 10 10 10 10 8 2 8 2 10 2 4 
5 5 5 1 4 9 10 10 12 1 12 3 12 9 8 4 
5 5 5 5 1 4 9 12 3 4 3 12 1 4 5 5 
3 4 5 5 5 5 5 1 12 1 12 5 5 5 1 6 
9 4 5 5 5 3 4 3 6 5 5 5 5 5 1 12 
5 5 1 4 3 12 3 8 10 6 5 5 5 5 5 5 
5 5 5 3 12 1 12 3 10 8 6 5 5 5 5 5 
5 5 3 12 3 4 3 10 10 2 8 6 5 5 5 5 
5 3 12 3 12 1 10 10 10 10 2 8 6 5 5 5 
3 12 3 12 5 3 10 10 10 10 10 2 8 6 5 5 
9 4 13 3 2 10 10 8 8 10 10 14 3 8 6 5 
7 3 2 10 10 10 10 6 3 10 10 10 10 2 10 6 
