9 10 10 10 10 8 10 10 10 10 8 10 10 10 10 12 
5 9 10 10 10 2 10 10 10 10 2 10 10 10 12 5 
5 5 9 10 8 10 10 10 10 10 10 8 10 12 5 5 
5 5 5 9 6 9 10 10 10 10 12 3 12 5 5 5 
5 5 1 6 9 6 9 10 10 12 3 12 3 4 5 5 
1 4 5 9 6 9 6 9 12 3 12 3 12 5 1 4 
5 5 5 5 9 2 8 6 3 12 3 12 5 1 4 5 
5 5 1 6 5 9 6 9 8 2 12 3 4 5 5 5 
5 5 1 12 5 1 12 3 6 9 6 9 4 5 5 5 
5 5 5 5 3 4 3 12 9 6 9 6 5 5 1 4 
1 4 5 3 12 3 12 3 6 9 6 9 6 5 5 5 
5 5 1 12 3 12 3 10 10 6 9 6 9 4 5 5 
5 5 5 3 12 3 10 10 10 10 6 9 6 5 5 5 
5 5 5 15 3 10 10 10 10 10 10 2 10 6 5 5 
5 5 3 10 10 10 10 10 10 10 10 10 10 10 6 5 
7 3 10 10 10 10 10 10 10 10 10 10 10 10 10 6 
