13 9 8 10 10 10 10 10 10 10 10 10 10 10 10 12 
5 5 5 13 9 12 11 10 10 10 10 10 10 8 12 5 
5 5 5 5 5 1 10 10 10 10 12 13 13 5 5 5 
5 5 5 5 5 5 9 10 10 10 6 5 5 5 5 5 
1 4 5 5 5 5 1 10 8 10 12 5 5 5 5 5 
5 5 5 5 5 5 5 11 6 13 5 5 5 5 5 5 
5 5 5 1 4 5 1 10 10 4 5 5 5 5 5 5 
5 5 5 5 5 5 5 9 8 4 5 3 0 0 2 4 
1 4 5 5 5 5 5 3 6 7 5 11 4 1 14 5 
5 5 1 4 5 5 1 10 10 10 4 13 5 5 13 5 
5 5 5 5 5 5 3 10 10 10 2 2 6 3 4 5 
5 5 5 7 5 3 10 10 10 10 8 10 10 12 5 5 
1 4 1 10 2 10 10 10 8 10 2 10 10 6 5 5 
5 5 1 10 10 10 10 10 2 10 10 10 10 10 4 5 
5 5 3 10 10 10 10 10 8 10 10 10 10 10 6 7 
7 3 10 10 10 10 10 10 2 10 10 10 10 10 10 14 
