11 10 8 12 9 12 13 9 12 9 8 12 9 10 10 12 
9 10 4 1 6 3 4 5 5 5 5 1 0 12 9 4 
1 12 5 1 8 12 5 5 5 5 5 5 5 5 5 5 
5 7 5 7 7 3 0 6 3 2 6 5 5 3 4 5 
1 12 3 14 11 12 7 9 8 8 8 6 3 12 3 6 
7 5 9 10 8 6 13 5 5 5 1 10 14 3 10 12 
9 6 3 10 2 10 6 3 6 7 3 10 12 9 10 4 
1 10 10 10 10 14 13 9 12 9 10 10 4 3 12 7 
5 9 10 10 10 12 5 1 6 3 10 8 0 12 1 14 
5 5 11 10 10 4 5 5 9 12 13 5 7 7 5 13 
5 1 10 8 14 3 6 1 6 1 4 1 10 12 5 5 
5 7 11 2 10 10 10 2 10 6 3 6 11 4 5 5 
5 11 10 8 12 9 10 12 13 9 10 10 12 7 3 4 
1 10 12 5 3 6 13 1 6 3 10 10 2 12 13 5 
5 13 5 1 12 9 2 2 12 11 10 8 8 6 3 4 
7 3 2 6 3 2 10 14 3 10 10 6 3 10 10 6 
