9 10 8 10 8 10 8 10 12 13 13 13 9 10 10 12 
5 11 2 10 2 10 4 9 4 1 4 5 5 9 12 5 
5 9 10 10 8 10 4 5 5 5 5 5 5 7 5 5 
5 3 8 14 3 10 2 6 3 6 1 4 3 10 6 5 
3 12 3 10 10 10 10 10 10 12 7 3 8 10 10 6 
11 2 8 14 9 10 10 10 10 2 12 11 2 10 8 14 
9 10 2 14 5 13 9 10 8 12 1 12 9 10 2 14 
3 10 10 12 5 5 5 9 4 5 5 5 3 10 8 12 
9 10 10 6 3 4 5 3 6 5 5 5 9 10 6 5 
3 10 10 8 14 3 0 10 10 6 5 5 1 8 8 4 
9 10 10 0 10 12 3 8 10 14 5 5 5 5 5 7 
1 10 12 5 13 5 13 3 10 10 6 5 3 4 1 12 
3 14 5 7 5 1 4 9 12 13 13 5 13 5 5 5 
9 10 2 8 6 5 5 5 5 1 4 3 4 5 1 4 
5 9 14 5 11 4 5 5 5 5 1 12 3 6 7 5 
7 3 10 2 10 6 3 6 3 6 7 3 10 10 10 6 
