9 10 10 10 10 10 10 10 10 10 10 10 10 10 8 12 
5 9 10 10 10 10 10 10 10 10 8 10 10 12 5 5 
5 5 9 10 10 10 10 10 10 12 5 9 12 5 5 5 
5 3 6 9 10 10 10 10 10 6 5 5 5 5 5 5 
5 13 9 6 9 12 9 10 10 12 5 5 5 5 5 5 
5 1 6 9 6 5 5 9 10 4 5 5 5 5 5 5 
5 3 10 6 9 6 5 3 14 1 6 5 5 5 5 5 
1 10 10 12 3 12 1 8 12 5 13 5 5 5 5 5 
5 9 12 3 10 6 5 3 6 5 1 6 5 5 5 5 
5 5 3 10 8 14 3 12 9 6 3 12 5 5 5 5 
5 3 10 12 3 12 9 2 2 10 12 5 5 5 5 5 
5 9 12 3 12 5 3 10 8 12 5 5 5 5 5 5 
3 4 5 9 6 3 10 10 6 3 6 5 5 5 7 5 
9 4 5 3 10 10 10 10 10 10 10 6 5 3 10 6 
5 5 3 10 10 10 10 10 10 10 10 10 2 10 10 12 
7 3 10 10 10 10 10 10 10 10 10 10 10 10 10 6 
