9 12 9 12 13 9 10 10 10 10 10 10 12 11 8 12 
5 5 5 1 2 6 13 9 12 11 12 9 6 9 6 5 
1 4 5 5 11 8 4 5 1 12 5 1 14 3 12 5 
5 3 6 5 13 5 3 6 7 3 4 3 10 10 6 5 
5 9 12 5 3 0 8 12 9 14 3 8 10 10 12 5 
5 5 5 3 8 6 5 5 5 9 10 2 10 12 1 4 
5 5 1 12 3 12 7 3 6 3 10 12 9 6 5 5 
1 4 5 3 12 3 12 9 12 9 12 7 5 11 6 7 
5 5 5 13 3 12 5 3 2 6 3 10 2 10 10 12 
1 4 5 1 12 5 3 12 9 10 10 10 10 10 10 6 
5 5 5 5 5 1 10 6 3 10 10 8 10 10 10 14 
1 4 5 5 5 1 10 14 11 10 10 4 9 8 8 12 
7 7 5 5 5 3 12 11 10 10 10 2 6 7 5 5 
9 10 0 4 5 13 3 8 14 13 13 13 13 9 6 5 
5 13 5 5 7 1 12 3 10 0 0 0 0 0 8 4 
7 3 6 3 14 7 3 10 10 6 7 7 7 7 7 7 
