9 10 10 10 12 9 10 10 10 10 8 12 9 10 10 12 
3 8 10 12 5 3 8 14 9 10 4 1 4 9 12 5 
9 4 9 4 1 10 0 10 0 10 4 5 5 5 5 5 
5 5 5 1 0 10 0 10 0 10 0 4 5 5 5 5 
5 5 7 5 3 10 0 10 0 10 4 5 5 5 5 5 
5 3 10 4 11 8 2 14 7 11 6 7 5 5 5 5 
5 9 12 5 13 5 9 8 10 10 8 8 6 5 5 5 
5 5 3 6 5 5 5 1 12 13 5 5 9 4 5 5 
5 5 9 8 6 5 5 3 6 5 5 5 5 5 5 5 
5 5 5 3 8 6 3 10 10 4 5 5 5 5 5 5 
5 5 3 12 3 12 9 10 12 5 5 5 5 5 5 5 
5 1 12 3 12 3 4 11 4 5 5 7 5 5 5 5 
3 4 1 12 3 12 1 10 6 5 5 11 6 5 5 5 
9 4 5 3 10 6 3 10 10 6 3 10 10 6 5 5 
5 5 3 10 10 10 10 10 12 9 8 10 10 10 6 5 
7 3 10 10 10 10 10 10 2 6 3 10 10 10 10 6 
