11 8 8 10 8 10 8 10 12 9 10 10 8 8 10 12 
9 6 3 10 0 10 2 14 1 2 12 9 6 3 12 5 
5 11 10 10 2 10 10 10 2 10 2 2 10 10 2 4 
1 10 10 10 10 10 10 10 10 10 10 10 10 10 10 4 
5 11 10 10 10 10 10 10 10 10 10 10 10 10 8 4 
1 10 10 10 8 10 14 9 12 9 12 9 12 9 6 5 
5 11 10 10 2 10 14 5 3 6 3 6 3 6 9 6 
1 10 10 10 10 10 12 1 12 11 10 10 12 9 6 13 
7 9 12 9 10 8 4 3 6 9 10 10 6 1 12 5 
13 7 1 2 8 4 1 10 10 0 14 11 8 6 5 5 
5 9 2 8 4 1 2 10 12 3 8 14 3 12 3 4 
1 2 8 4 1 2 8 14 5 9 6 9 12 3 12 5 
3 8 4 1 0 10 6 13 5 3 12 5 3 12 1 4 
9 4 1 6 5 11 8 2 6 9 6 5 13 5 7 5 
5 3 6 9 6 9 4 9 12 3 8 6 1 2 12 5 
7 11 10 2 10 6 3 6 3 10 2 10 2 10 2 6 
