9 10 10 8 10 10 8 8 10 10 10 8 8 8 10 12 
1 10 10 2 10 10 4 7 9 10 12 5 5 5 13 5 
1 10 8 10 8 12 1 10 4 15 5 5 5 5 7 5 
5 13 5 13 5 5 5 13 3 10 6 5 3 2 10 4 
7 5 7 5 7 5 7 1 10 8 10 0 10 10 10 4 
9 2 8 2 8 6 11 4 11 2 14 5 9 10 12 5 
5 13 5 13 5 13 9 2 8 8 12 5 5 15 5 5 
5 5 7 5 7 5 5 9 4 5 3 4 3 8 6 5 
3 2 8 2 10 6 5 3 6 5 9 2 14 1 10 4 
9 10 2 10 10 12 3 10 10 6 7 11 10 2 8 4 
5 9 10 10 8 4 13 9 10 14 9 10 10 12 5 5 
7 3 10 12 5 1 4 5 11 10 4 11 10 4 5 5 
9 10 10 4 1 4 7 1 10 14 1 10 14 5 1 4 
5 9 10 6 5 1 10 4 11 10 4 11 10 4 5 5 
5 3 10 8 6 5 13 1 10 14 1 10 14 5 5 5 
7 11 10 2 10 6 3 2 10 10 6 11 10 2 2 6 
