9 10 10 10 10 10 10 10 10 10 8 8 8 8 12 13 
5 9 10 10 10 10 10 10 10 12 5 7 7 7 1 6 
5 3 10 10 8 10 10 14 13 5 5 9 10 12 3 12 
1 10 10 10 2 10 10 12 1 4 5 1 8 2 12 5 
3 10 10 10 10 10 12 5 5 1 6 3 6 13 7 5 
11 8 10 10 10 10 6 7 5 3 8 10 10 2 10 4 
11 2 8 10 10 14 9 14 1 8 2 10 10 10 12 5 
11 8 6 9 10 12 5 9 4 3 10 10 10 14 5 5 
9 6 9 6 9 6 5 3 6 13 11 10 8 12 5 5 
5 9 6 9 6 9 0 10 10 6 9 12 5 1 4 5 
1 6 9 6 13 5 7 9 12 13 5 5 5 5 5 5 
7 9 6 9 2 6 9 6 5 5 5 5 5 5 5 5 
11 2 8 0 14 9 6 9 6 5 5 5 5 5 5 5 
9 8 4 5 9 6 9 6 9 4 5 5 5 5 5 5 
5 7 5 1 6 9 6 9 4 1 4 5 5 3 6 5 
7 11 6 7 11 2 10 6 7 7 7 3 2 10 10 6 
