9 10 8 8 10 14 9 8 8 10 10 10 10 10 10 12 
5 9 6 1 10 8 4 7 1 10 10 10 10 10 12 5 
5 3 12 5 9 4 3 10 6 9 10 10 10 10 6 5 
5 9 6 3 4 7 9 10 10 2 10 10 10 10 12 5 
5 5 9 12 3 14 1 10 10 10 10 10 10 10 6 5 
5 1 4 3 8 10 6 9 10 10 8 10 10 10 10 6 
3 4 3 14 3 8 12 5 11 12 1 12 9 12 9 12 
9 2 10 10 10 6 5 1 12 5 5 3 6 3 4 5 
5 9 10 10 10 12 7 3 6 5 3 10 10 12 5 5 
5 5 9 10 10 6 9 10 10 2 10 8 10 6 5 5 
3 4 5 9 10 10 2 10 10 10 12 3 10 10 4 5 
9 4 5 5 9 10 10 10 10 10 2 10 10 10 4 5 
5 5 5 5 3 10 10 10 10 10 12 9 10 10 2 4 
5 5 5 1 10 10 10 10 10 12 5 3 10 10 12 5 
5 5 3 6 9 8 10 10 10 6 5 9 10 10 6 5 
7 3 10 10 6 3 10 10 10 10 2 2 10 10 10 6 
