9 10 10 10 10 8 10 10 10 10 10 10 10 14 9 12 
5 9 10 10 10 2 10 10 10 10 10 10 10 10 4 5 
5 5 13 11 8 8 12 9 8 12 9 10 8 12 5 5 
5 5 3 8 4 5 5 5 5 3 6 13 7 5 5 5 
1 4 9 6 7 7 3 6 5 9 12 5 9 4 5 5 
5 5 3 10 10 8 8 14 5 5 5 5 5 7 5 5 
5 5 9 10 14 5 5 9 6 1 0 2 6 13 5 5 
5 5 1 10 14 3 4 1 12 5 3 14 13 5 5 5 
5 5 3 10 8 12 5 3 6 5 13 9 4 5 7 5 
5 5 9 10 6 1 2 14 9 6 3 4 3 4 9 4 
5 5 1 10 8 6 13 11 2 10 12 3 12 1 4 5 
5 5 1 12 1 12 1 10 10 10 2 14 3 4 5 5 
5 5 5 5 7 1 0 10 14 9 10 10 8 6 5 5 
5 5 5 3 14 7 3 10 10 6 11 10 2 12 5 5 
5 5 3 10 10 10 10 10 12 11 10 10 10 2 2 4 
7 3 10 10 10 10 14 11 2 10 10 10 10 10 10 6 
