9 10 10 10 10 10 10 10 10 10 10 10 10 8 10 12 
3 10 10 8 10 10 10 14 9 10 10 10 8 4 13 5 
13 11 10 2 10 10 8 14 1 10 10 10 4 7 1 4 
5 11 10 10 8 10 6 13 3 10 10 8 0 10 6 5 
5 11 8 10 2 10 14 1 12 9 12 5 1 10 12 5 
1 10 6 9 10 10 10 6 3 6 3 6 7 13 5 5 
1 10 14 3 10 10 10 10 10 10 8 10 10 4 5 5 
1 10 10 10 10 10 14 9 12 9 2 14 9 6 5 5 
3 10 10 10 8 10 12 1 6 5 11 10 2 12 5 5 
9 10 10 8 6 13 5 3 10 6 9 12 9 6 5 5 
3 10 8 6 9 6 5 13 13 13 5 5 3 12 5 5 
11 8 6 9 6 9 4 5 5 1 4 5 13 3 6 5 
9 6 9 6 9 4 5 5 5 5 5 1 4 9 8 4 
3 8 6 9 4 5 5 5 5 5 5 5 5 5 5 5 
9 4 9 4 5 5 5 5 5 5 7 7 5 5 5 5 
7 3 6 7 3 6 3 2 2 2 10 14 3 2 2 6 
