9 10 10 10 10 8 10 8 10 10 10 8 10 14 9 12 
1 10 12 9 8 4 13 5 9 10 12 1 12 9 6 5 
5 9 6 5 5 3 6 5 3 12 5 5 3 6 9 4 
1 4 9 4 7 9 12 3 10 6 5 3 10 10 6 5 
7 5 5 7 9 6 1 10 10 10 2 8 10 10 10 4 
9 2 6 9 2 12 5 9 10 10 10 4 9 10 10 4 
1 14 9 6 13 5 5 3 10 8 14 5 1 10 12 5 
5 9 4 9 4 5 5 9 12 5 9 6 3 12 5 5 
5 5 3 4 1 6 3 2 6 1 6 9 12 5 5 5 
5 3 12 5 3 8 14 9 12 5 9 6 3 6 5 5 
3 12 5 3 12 5 9 6 5 5 5 9 10 10 6 5 
9 6 3 12 5 5 5 9 6 5 5 5 9 10 10 4 
5 9 12 5 5 7 5 5 9 6 5 5 5 9 14 5 
1 4 5 5 3 10 6 5 1 10 6 5 5 3 10 6 
5 5 5 3 10 10 10 2 2 10 10 4 1 10 10 12 
7 3 2 10 10 10 10 10 10 10 10 2 6 11 10 6 
