9 10 10 14 9 10 10 8 10 10 8 10 10 8 8 12 
5 13 9 12 5 13 9 0 14 11 0 14 9 6 5 5 
1 4 5 5 1 0 4 1 10 10 0 10 2 14 5 5 
5 5 5 1 4 5 7 7 13 9 4 13 11 12 5 5 
5 5 5 5 7 3 10 10 2 6 1 2 10 4 5 5 
5 5 5 5 13 9 10 10 12 13 5 13 13 5 5 5 
5 5 5 5 5 1 10 10 2 4 5 5 1 4 5 5 
5 5 5 5 5 3 12 9 8 6 7 5 5 5 5 7 
5 5 5 5 5 9 6 3 6 9 12 5 5 5 3 12 
5 5 5 5 5 3 12 9 10 6 7 5 5 5 9 4 
5 5 5 5 5 9 6 3 10 10 10 4 5 1 4 5 
5 1 0 4 5 5 13 9 10 10 10 6 5 5 5 5 
5 7 7 5 5 3 2 2 10 10 10 10 6 7 5 5 
1 12 13 3 2 10 10 10 10 10 10 10 10 10 4 5 
5 3 2 10 10 12 9 12 9 12 11 10 10 10 6 5 
7 11 10 10 10 2 6 3 6 3 10 10 10 10 10 6 
