9 8 10 10 10 10 10 10 10 10 8 12 9 10 10 12 
5 5 9 12 9 12 9 12 9 12 5 5 5 11 12 5 
5 3 6 3 6 3 6 3 6 5 5 5 3 10 6 5 
5 9 10 10 10 10 10 10 10 6 7 3 8 10 10 6 
5 5 9 10 10 10 10 10 12 11 10 8 2 10 10 12 
5 5 5 9 10 10 10 10 6 11 8 2 10 10 12 5 
5 5 5 3 10 10 8 14 11 8 2 14 9 10 6 5 
5 5 5 9 10 12 5 9 12 3 12 11 2 10 10 4 
5 5 3 6 9 6 3 2 6 9 6 9 10 10 12 5 
5 3 10 10 2 10 10 8 10 6 11 2 10 12 5 5 
3 8 10 12 9 10 12 3 10 10 10 10 10 6 5 5 
9 2 12 5 3 10 4 11 10 10 10 10 10 12 5 5 
1 8 6 3 10 10 4 9 10 10 10 10 10 4 5 5 
5 5 9 10 10 10 6 3 10 10 10 10 12 5 5 5 
5 5 3 10 10 10 10 10 10 10 10 10 6 3 6 5 
7 3 10 10 10 10 10 10 10 10 10 10 10 10 10 6 
