9 14 9 10 8 8 10 12 9 10 10 10 10 10 10 12 
5 9 6 9 4 1 10 2 2 10 10 10 10 10 12 5 
1 6 9 6 5 3 8 10 10 10 10 10 10 12 1 4 
1 8 6 9 4 9 2 10 10 10 10 10 12 1 6 5 
5 5 9 6 1 6 9 10 10 10 10 12 1 4 13 5 
5 5 5 9 4 9 6 9 10 10 12 1 4 5 5 5 
5 5 5 5 1 2 8 2 10 12 1 4 5 5 5 5 
3 4 5 5 5 9 6 9 12 5 5 5 5 5 1 6 
9 4 5 5 5 5 9 2 6 1 6 5 5 5 1 12 
5 5 5 5 5 5 3 10 8 6 9 6 5 5 5 5 
5 5 5 5 5 3 8 10 6 9 2 8 2 6 5 5 
5 5 5 5 3 8 2 10 10 6 9 6 9 10 4 5 
5 5 5 3 10 2 10 10 10 8 6 9 6 9 6 5 
5 1 2 10 10 10 10 10 10 2 10 6 9 6 11 4 
5 3 10 10 10 10 10 8 8 10 10 10 6 9 8 6 
7 11 10 10 10 10 10 6 3 10 10 10 10 6 3 14 
