9 10 10 8 10 8 8 10 8 10 10 8 10 10 12 15 
5 15 9 6 9 6 5 11 0 14 9 2 8 10 2 12 
5 9 6 9 6 11 2 10 0 14 3 8 2 8 10 4 
1 6 9 6 9 10 12 11 0 14 9 2 10 2 12 5 
5 9 6 9 6 9 4 11 0 14 1 10 8 10 2 4 
1 6 9 6 15 5 5 11 0 10 4 13 5 9 10 4 
5 9 6 9 10 6 1 14 3 8 0 6 5 3 12 5 
1 6 15 5 9 12 5 9 12 5 7 9 0 12 5 5 
3 10 10 6 5 5 3 2 6 7 9 6 5 5 5 5 
11 10 10 8 2 2 10 8 14 9 6 15 5 5 5 5 
11 10 8 2 10 10 8 6 9 6 9 10 6 5 5 5 
9 10 2 10 8 10 6 9 6 15 5 9 10 4 5 5 
5 9 10 12 1 10 8 0 10 10 6 5 15 5 5 5 
5 1 10 2 4 15 5 3 10 10 10 2 10 6 5 5 
1 4 11 10 2 10 2 10 10 10 10 10 10 10 6 5 
7 3 10 10 10 10 10 10 10 10 10 10 10 10 10 6 
