9 14 9 10 8 8 10 12 9 10 10 10 10 10 10 12 
5 9 6 9 4 1 10 2 2 10 10 12 9 10 12 5 
1 6 9 6 5 3 8 10 10 10 10 6 3 12 1 4 
1 8 6 9 4 9 6 11 10 10 10 10 12 1 6 5 
5 7 9 6 1 6 9 10 10 10 10 12 1 4 13 5 
5 13 5 9 4 11 6 9 10 10 12 1 4 5 5 5 
5 5 5 5 1 10 12 3 10 12 1 6 5 5 5 5 
3 4 5 5 5 9 6 9 12 5 5 13 5 5 1 6 
9 4 5 5 5 5 9 2 6 1 6 5 5 5 1 12 
5 5 5 5 5 5 3 10 10 6 9 6 5 5 5 5 
5 5 5 5 5 3 8 10 14 9 2 12 3 6 5 5 
5 5 5 5 3 8 2 10 10 6 9 6 9 10 4 5 
5 5 5 3 10 2 10 10 10 8 6 9 6 9 6 5 
5 1 2 10 10 10 10 10 10 2 10 6 9 6 11 4 
5 3 10 10 10 10 10 8 8 10 10 10 6 9 8 6 
7 11 10 10 10 10 10 6 3 10 10 10 10 6 3 14 
