9 10 10 14 13 11 10 10 10 10 10 8 10 8 10 12 
5 11 10 10 0 8 8 10 10 10 12 5 13 5 13 5 
1 10 10 8 6 5 1 10 10 10 4 5 5 5 5 5 
5 9 10 2 14 5 5 9 8 10 4 7 5 5 5 5 
5 5 9 10 10 6 7 7 5 11 0 12 5 5 5 5 
5 5 5 9 12 9 10 10 2 14 5 5 5 5 5 7 
5 5 5 5 5 5 9 10 10 12 5 5 3 0 2 14 
5 5 3 4 5 5 5 9 8 4 5 3 12 1 10 14 
5 3 10 6 5 7 7 3 6 5 5 13 5 5 9 12 
5 11 10 12 1 12 9 10 10 4 7 5 5 1 6 5 
1 10 10 4 5 5 5 9 12 3 12 5 5 5 11 6 
5 11 8 0 4 5 5 5 3 10 6 3 0 0 12 13 
5 9 6 5 7 5 1 2 10 10 8 14 5 5 1 4 
5 5 9 6 9 4 7 9 10 10 0 10 6 5 5 5 
1 6 5 9 4 1 10 0 10 10 2 10 10 6 5 7 
7 11 2 6 7 3 14 3 10 10 10 10 10 10 2 14 
