9 10 10 10 10 10 10 10 10 10 10 10 10 10 10 12 
5 9 10 10 10 10 10 10 10 10 10 10 10 10 12 5 
5 5 9 10 10 10 10 8 10 8 10 10 10 12 5 5 
5 5 5 13 9 10 12 1 14 1 14 9 12 5 5 5 
5 5 3 4 5 9 6 5 9 6 9 6 5 5 5 5 
5 5 13 5 5 3 10 4 5 9 6 9 6 5 5 5 
5 5 1 6 5 9 12 7 3 6 9 6 13 5 5 5 
5 5 5 13 5 5 5 9 12 9 6 9 4 5 5 5 
5 5 1 6 5 5 5 3 4 1 10 4 5 5 5 5 
1 2 0 10 4 5 3 10 4 7 9 2 6 5 5 5 
5 9 2 8 6 3 10 12 5 9 6 9 12 5 5 5 
1 2 8 2 8 10 12 5 5 3 10 6 5 5 5 5 
1 10 0 10 0 10 4 5 3 10 10 10 6 5 5 5 
1 8 2 8 2 8 4 5 11 10 10 10 10 6 5 5 
5 3 8 2 8 6 5 3 10 10 10 10 10 10 6 5 
7 11 2 10 2 10 2 10 10 10 10 10 10 10 10 6 
