9 8 8 12 9 10 10 10 10 10 10 10 10 10 8 12 
5 5 5 5 5 9 10 10 12 11 8 10 10 10 6 7 
5 5 5 5 5 3 12 9 6 9 2 8 10 8 10 12 
5 1 4 5 1 14 5 5 11 0 10 2 10 2 12 5 
5 5 1 4 5 9 4 3 12 3 10 10 12 11 2 4 
5 5 5 5 5 5 7 9 6 9 12 15 5 9 10 6 
5 5 5 5 5 1 12 3 10 6 3 10 6 5 9 12 
5 1 0 4 5 7 5 9 8 10 10 10 10 2 6 5 
5 5 5 5 5 9 6 3 6 9 10 8 10 10 12 5 
5 1 4 5 5 1 8 10 12 3 12 3 12 9 4 5 
5 5 1 4 5 5 7 9 2 12 3 12 3 4 5 5 
5 5 7 5 5 5 9 6 13 3 12 3 12 3 4 5 
5 3 8 2 6 1 6 11 0 14 3 12 3 12 3 4 
5 11 6 11 8 4 11 8 2 8 14 3 12 3 12 7 
1 12 11 8 6 1 10 2 10 2 8 14 3 12 3 12 
7 3 10 2 10 2 10 10 10 10 2 10 14 3 10 6 
