9 8 10 10 10 10 8 8 10 10 10 10 10 12 9 12 
5 5 9 10 10 14 5 5 11 10 10 10 12 5 5 5 
5 7 5 11 10 10 4 3 10 10 10 10 2 0 6 5 
3 12 1 10 8 14 1 8 10 10 8 10 10 0 12 5 
9 6 1 12 1 10 6 3 10 12 5 13 9 6 5 5 
5 13 7 1 6 9 10 10 12 3 4 1 0 10 6 5 
5 3 10 4 9 6 9 12 3 12 5 5 1 10 8 6 
1 12 9 6 5 9 6 1 12 5 5 5 5 9 2 12 
5 5 5 9 6 3 12 3 6 5 5 5 1 0 12 5 
5 5 5 3 10 12 3 8 10 6 5 3 6 5 5 5 
5 5 1 12 11 0 10 6 9 10 2 8 14 5 5 5 
1 4 5 3 12 5 9 10 6 9 12 1 10 4 1 6 
5 5 3 10 2 2 6 9 10 6 5 1 10 6 1 12 
5 1 10 10 10 10 12 5 9 10 2 0 10 14 5 5 
5 3 10 8 8 10 2 6 5 11 12 3 10 8 4 5 
7 11 10 6 3 10 10 10 2 10 2 10 10 6 7 7 
