11 10 10 8 10 10 8 10 8 10 10 8 14 11 8 12 
9 8 12 5 13 9 2 10 6 9 14 3 10 10 4 5 
5 5 5 5 5 3 12 13 9 2 10 10 10 12 3 4 
1 2 4 5 5 9 6 1 6 11 8 10 12 3 10 4 
3 12 5 5 5 3 12 5 9 10 2 14 3 10 10 6 
9 2 4 5 5 9 6 5 3 10 8 10 12 9 12 13 
3 12 5 5 5 3 12 3 10 12 1 8 2 4 1 4 
9 6 5 5 5 9 6 9 12 5 5 1 8 2 4 5 
3 12 5 5 1 6 13 3 4 5 3 4 1 8 2 4 
9 6 5 1 6 9 4 11 4 3 12 3 4 1 8 6 
3 12 3 6 9 6 3 12 3 12 3 12 3 4 1 12 
9 2 14 9 4 9 12 3 12 3 12 3 12 3 4 5 
3 12 9 6 7 5 3 12 3 12 3 12 3 12 7 5 
9 2 2 12 9 2 8 2 12 3 12 3 12 3 12 5 
5 9 10 6 3 10 2 10 2 10 6 11 2 10 6 5 
7 3 10 10 10 10 10 10 10 10 10 10 10 10 10 6 
