j9 10 8 14 9 10 8 10 10 10 10 10 10 12 9 12 
5 9 2 8 6 9 6 9 10 10 10 10 10 6 5 5 
1 4 9 6 9 6 11 2 10 10 10 10 12 9 4 5 
5 1 6 9 6 9 10 10 10 10 10 10 6 5 5 5 
1 6 9 6 11 2 10 10 10 10 10 8 14 5 5 5 
5 9 6 13 13 13 13 9 10 10 10 6 9 6 5 5 
1 6 13 1 0 0 0 2 14 9 10 12 5 9 6 5 
1 8 4 5 5 7 7 9 12 3 12 5 5 3 12 5 
5 5 5 1 2 10 10 2 6 9 6 5 5 9 6 5 
3 0 4 1 8 10 10 10 10 2 14 5 5 3 12 5 
13 5 5 7 7 9 12 9 12 9 12 3 6 9 6 5 
1 4 3 8 10 4 3 6 3 4 5 9 10 0 10 4 
5 3 8 0 10 6 9 10 10 4 3 2 8 2 12 5 
1 10 4 3 12 9 2 14 11 2 12 9 2 10 6 5 
5 13 3 12 3 6 9 10 10 12 3 6 9 10 10 4 
7 3 10 2 10 10 2 14 11 2 10 10 2 14 11 6 
