9 14 13 13 9 12 9 12 9 12 11 10 10 12 11 12 
1 10 4 1 6 3 6 3 6 3 8 12 9 4 13 5 
1 14 3 4 11 8 14 9 12 9 6 5 5 1 0 6 
1 14 11 2 8 2 12 5 1 2 14 1 6 5 1 14 
3 8 10 8 2 12 3 6 1 14 9 6 11 4 1 12 
11 4 11 6 11 6 9 10 6 13 3 12 9 6 5 5 
13 1 14 9 10 10 6 11 12 1 10 2 0 8 2 6 
1 4 13 1 12 15 9 12 1 2 10 14 5 1 10 12 
5 7 3 4 5 13 3 2 0 12 9 12 5 7 11 4 
1 10 8 0 6 5 11 10 6 7 7 1 2 10 12 5 
5 9 6 3 12 5 11 10 14 11 14 5 11 10 6 5 
1 2 12 9 6 5 13 9 10 10 12 5 13 11 8 6 
1 14 5 3 12 5 5 3 12 9 6 5 5 9 2 12 
1 10 4 9 6 5 5 9 4 5 11 6 1 2 12 5 
1 12 3 2 14 7 1 6 5 1 10 8 2 14 1 6 
7 3 10 10 10 10 6 11 2 6 11 6 11 10 2 14 
