9 10 8 10 10 10 8 8 14 11 8 10 10 8 10 12 
5 9 6 9 10 10 6 3 10 10 6 9 10 2 12 5 
1 6 9 6 9 10 10 12 11 10 8 2 10 12 1 4 
5 9 6 15 5 15 9 2 14 9 2 10 12 1 4 5 
5 5 9 10 6 9 6 9 10 2 8 12 1 6 3 4 
5 5 5 15 9 6 9 2 10 10 4 1 6 13 9 6 
1 2 6 9 6 13 1 10 10 12 1 0 14 1 6 13 
5 9 10 6 9 4 5 9 12 1 4 5 9 6 13 5 
7 5 13 13 5 5 5 1 6 5 1 6 5 9 0 4 
13 5 1 4 5 5 3 2 10 2 6 9 6 5 5 5 
1 6 5 5 5 3 10 10 8 14 9 6 15 5 5 5 
5 9 4 5 3 10 12 9 6 9 6 9 10 6 5 5 
5 5 5 3 10 10 6 3 8 6 15 5 15 9 6 5 
5 7 3 10 8 10 10 14 3 10 10 6 9 6 9 4 
1 10 8 10 6 9 10 10 10 8 10 8 6 9 6 5 
7 11 2 10 10 2 10 10 10 2 10 2 10 2 10 6 
