9 10 10 10 8 10 14 11 12 11 8 12 9 12 9 12 
5 11 8 10 6 9 8 8 6 9 6 3 4 5 5 5 
5 9 4 9 10 6 5 5 15 1 14 13 5 5 5 5 
5 7 5 1 14 13 5 3 10 6 9 4 5 5 5 5 
3 12 5 3 12 5 3 8 14 9 6 1 4 5 5 5 
15 5 3 12 5 3 10 4 9 2 12 5 5 3 4 5 
9 2 12 5 3 12 9 0 6 9 2 4 7 9 6 5 
7 13 5 3 10 6 5 1 12 3 12 7 9 6 9 4 
13 5 3 10 12 11 4 3 6 13 3 12 5 9 6 7 
5 5 11 12 5 13 3 8 10 2 10 4 5 5 9 12 
5 1 10 2 6 5 13 3 8 10 10 4 5 5 5 5 
3 2 10 8 12 1 4 13 3 8 10 4 5 5 5 5 
9 10 10 6 3 6 5 1 12 3 8 6 5 5 5 5 
3 10 10 10 10 12 3 6 1 14 3 10 6 1 6 5 
9 8 10 10 10 2 10 12 1 8 10 14 13 7 9 4 
7 3 10 10 10 10 10 2 6 3 10 10 2 10 6 7 
