9 10 12 9 10 10 10 10 10 10 10 10 10 10 10 12 
5 13 5 3 8 8 14 9 8 10 10 10 10 10 12 5 
5 1 6 13 7 5 9 4 1 14 9 10 8 14 5 5 
5 5 9 6 9 6 5 1 0 12 3 12 3 12 5 5 
5 5 5 9 6 9 6 5 5 3 12 3 12 5 3 6 
5 5 1 4 9 4 11 4 1 14 1 8 4 5 9 12 
5 5 5 7 5 5 9 2 2 12 5 7 7 5 5 5 
5 5 5 13 5 5 3 8 8 6 5 9 12 5 5 5 
5 5 5 5 5 3 12 3 6 9 6 5 5 5 5 5 
5 3 6 5 3 12 3 12 9 6 9 6 5 5 5 5 
5 9 8 2 12 3 12 3 6 9 6 9 6 3 6 5 
5 5 7 13 3 12 3 12 9 6 9 6 9 10 10 6 
5 5 13 3 12 3 12 3 6 9 6 11 2 10 10 12 
5 3 4 11 2 12 3 10 10 6 11 10 8 10 10 6 
1 12 3 10 10 2 10 10 8 10 14 11 2 10 10 12 
7 3 10 10 10 10 10 10 2 10 10 10 10 10 10 6 
