9 12 9 12 9 10 12 9 12 9 8 10 12 9 8 12 
5 5 5 5 3 12 3 6 5 5 5 9 6 5 7 5 
5 5 5 3 12 3 10 12 3 6 5 5 15 5 9 6 
5 5 5 15 3 10 12 3 10 12 5 5 15 5 3 12 
5 3 4 11 12 15 3 10 10 6 5 3 10 6 11 4 
5 13 1 14 1 10 10 10 10 8 4 9 10 12 9 6 
1 4 7 11 2 10 8 10 14 5 5 5 9 6 3 12 
5 5 9 12 9 8 6 9 8 6 1 6 3 12 9 6 
7 5 5 5 7 3 12 3 6 15 7 13 9 6 3 12 
15 5 5 5 9 12 5 9 12 9 10 4 3 12 9 6 
9 4 5 5 5 5 5 5 5 5 13 3 8 6 1 12 
5 5 5 5 5 5 3 6 3 0 6 9 6 9 6 5 
5 5 5 5 5 3 10 10 10 6 9 6 9 6 9 4 
5 5 5 3 2 10 10 10 10 8 6 9 6 9 4 5 
5 5 3 10 10 10 8 10 14 3 10 6 9 6 5 5 
7 3 10 10 10 10 2 10 10 10 10 10 2 10 2 6 
