9 8 8 8 8 8 8 8 8 8 8 8 8 8 8 12 15 
1 0 0 0 0 0 0 0 0 0 0 0 0 0 0 4 15 
1 0 0 0 0 0 0 0 0 0 0 0 0 0 0 4 15 
1 0 0 0 0 0 0 0 0 0 0 0 0 0 0 4 15 
1 0 0 0 0 0 0 0 0 0 0 0 0 0 0 4 15 
1 0 0 0 0 0 0 0 0 0 0 0 0 0 0 4 15 
1 0 0 0 0 0 0 2 2 0 0 0 0 0 0 4 15 
1 0 0 0 0 0 4 9 12 1 0 0 0 0 0 4 15 
1 0 0 0 0 0 4 3 6 1 0 0 0 0 0 4 15 
1 0 0 0 0 0 0 8 8 0 0 0 0 0 0 4 15 
1 0 0 0 0 0 0 0 0 0 0 0 0 0 0 4 15 
1 0 0 0 0 0 0 0 0 0 0 0 0 0 0 4 15 
1 0 0 0 0 0 0 0 0 0 0 0 0 0 0 4 15 
1 0 0 0 0 0 0 0 0 0 0 0 0 0 0 4 15 
5 1 0 0 0 0 0 0 0 0 0 0 0 0 0 4 15 
7 3 2 2 2 2 2 2 2 2 2 2 2 2 2 6 15 
15 15 15 15 15 15 15 15 15 15 15 15 15 15 15 15 15 
