13 11 10 10 10 10 12 9 8 10 12 11 8 12 9 14 15 
1 12 9 8 10 14 1 6 1 12 3 8 6 1 2 12 15 
5 5 5 1 10 8 6 9 6 5 13 5 9 2 12 5 15 
5 3 6 7 9 6 9 6 9 6 5 5 3 8 0 4 15 
1 10 10 10 6 9 6 9 6 9 4 5 9 6 5 7 15 
1 10 10 14 9 6 9 6 9 4 5 5 3 8 2 12 15 
1 10 14 9 6 9 6 11 6 5 5 5 9 2 12 5 15 
1 14 9 6 9 6 13 9 12 5 5 5 3 12 1 4 15 
5 9 6 9 6 9 4 3 4 1 4 5 9 2 4 7 15 
1 6 9 6 9 6 1 8 4 5 5 5 3 8 2 12 15 
5 9 6 9 2 14 7 7 5 5 5 5 9 2 12 5 15 
5 5 11 2 10 10 12 13 5 5 5 5 3 8 0 4 15 
5 1 10 8 10 12 3 4 5 5 5 5 9 6 5 5 15 
5 5 9 4 13 3 12 7 5 7 3 6 3 8 4 7 15 
5 5 5 5 1 12 3 8 0 12 9 12 9 4 1 12 15 
7 3 6 3 6 3 10 6 7 3 6 3 6 3 6 7 15 
