9 14 11 10 10 10 12 9 10 10 10 10 10 10 10 12 15 
1 8 10 10 10 12 5 5 9 10 10 10 10 10 12 5 15 
5 5 9 10 12 5 5 5 5 9 12 9 10 12 5 5 15 
5 5 5 15 5 5 5 5 5 5 5 3 12 5 5 5 15 
5 5 3 8 2 6 5 5 5 5 5 9 4 5 5 5 15 
5 7 11 2 10 10 2 4 1 6 3 6 7 5 5 5 15 
1 10 10 10 10 10 14 7 7 9 10 10 10 6 5 5 15 
3 10 10 10 10 10 12 9 12 5 9 10 10 10 6 5 15 
13 9 10 8 10 10 6 3 4 5 3 10 10 10 10 6 15 
5 5 13 5 9 10 12 13 5 5 9 12 9 12 9 12 15 
5 5 5 1 2 12 1 4 5 5 5 3 6 3 6 5 15 
5 5 5 5 15 5 5 5 5 5 3 12 9 12 13 5 15 
5 5 5 3 10 6 5 5 5 5 13 5 5 5 5 5 15 
5 7 3 10 10 10 6 5 5 5 5 3 6 3 4 5 15 
1 10 10 10 10 10 12 5 5 3 2 10 10 10 6 5 15 
7 11 10 10 10 10 2 6 3 10 10 10 10 10 10 6 15 
