11 12 9 12 9 10 10 10 10 10 10 10 8 10 8 14 15 
13 1 6 5 5 9 10 10 10 10 10 10 4 15 5 15 15 
1 2 12 3 6 3 10 8 10 10 10 10 2 8 2 12 15 
1 14 5 9 10 10 10 2 10 10 10 8 14 5 15 5 15 
7 9 4 3 12 9 12 9 12 9 12 3 12 3 8 6 15 
9 6 5 9 6 1 0 6 3 6 5 9 6 15 5 15 15 
5 11 4 3 12 5 1 10 10 12 5 3 12 9 2 12 15 
1 12 7 9 6 5 5 9 8 4 1 8 6 3 8 6 15 
5 3 12 3 8 4 5 3 6 5 5 3 12 9 2 12 15 
1 14 5 9 6 5 3 10 10 4 5 9 6 3 8 6 15 
7 9 6 3 12 5 9 12 9 4 5 3 12 15 5 15 15 
9 6 13 9 6 3 6 3 6 3 6 9 6 9 2 12 15 
5 11 4 3 10 10 10 10 8 10 10 2 14 5 15 5 15 
1 12 3 8 10 8 10 12 1 10 10 10 8 2 8 6 15 
5 3 12 5 13 3 12 7 3 10 10 10 4 15 5 15 15 
7 11 2 2 2 14 3 10 10 10 10 10 2 10 2 14 15 
