11 8 10 10 10 10 10 10 10 10 10 10 10 10 8 14 15 
11 2 10 10 10 10 8 8 12 15 13 15 13 15 5 15 15 
11 10 10 10 10 10 4 5 5 9 2 8 2 8 2 12 15 
9 8 10 10 10 10 2 2 6 5 15 5 15 5 15 5 15 
5 1 10 10 10 10 10 10 14 3 8 2 8 2 8 6 15 
3 2 10 10 10 10 8 8 12 15 5 15 5 15 5 15 15 
11 10 10 10 10 10 4 7 7 9 2 8 2 8 2 12 15 
9 8 8 8 10 10 4 9 12 5 15 5 15 5 15 5 15 
5 1 4 3 12 9 6 3 2 2 8 2 8 2 8 6 15 
1 4 3 12 3 4 9 12 13 15 5 15 5 15 5 15 15 
5 1 12 3 12 1 6 1 4 9 2 8 2 8 2 12 15 
1 4 1 8 0 6 9 4 5 5 15 5 15 5 15 5 15 
5 5 5 5 1 8 4 5 5 3 8 2 8 2 8 6 15 
1 4 5 5 5 5 5 5 5 15 5 15 5 15 5 15 15 
5 5 5 5 5 5 5 5 5 11 2 10 2 8 2 12 15 
7 3 2 2 6 7 3 2 2 10 10 10 10 6 15 7 15 
