9 10 8 10 8 10 8 10 8 10 8 10 12 9 8 12 
1 10 0 10 0 10 0 10 0 10 0 10 0 4 5 5 
1 10 0 10 0 10 0 10 0 10 0 10 4 5 5 5 
1 10 0 10 0 10 0 10 0 10 0 10 0 4 5 5 
1 10 0 10 0 10 0 10 0 10 0 10 4 5 5 5 
1 10 0 10 0 10 0 10 2 10 2 10 2 6 5 5 
1 10 0 10 0 10 0 14 9 10 10 10 10 10 6 5 
1 10 0 10 0 10 4 9 4 9 10 8 10 8 10 4 
1 10 0 10 0 10 4 3 6 3 8 2 8 2 8 4 
1 10 0 10 0 10 0 10 8 10 0 10 0 10 4 5 
1 10 0 10 0 10 0 10 0 10 0 10 0 10 0 4 
1 10 0 10 0 10 0 10 0 10 0 10 0 10 4 5 
1 10 0 10 0 10 0 10 0 10 0 10 0 10 0 4 
1 10 0 10 0 10 0 10 0 10 0 10 0 10 4 5 
1 8 2 8 2 8 2 8 2 8 2 8 2 8 2 4 
7 3 10 2 10 2 10 2 10 2 10 2 10 2 10 6 
