9 10 10 10 10 12 15 9 8 10 8 8 8 8 12 13
1 10 8 10 12 3 8 4 3 12 5 5 7 7 1 4
1 10 0 12 3 12 7 7 9 6 7 1 14 9 4 5
1 14 5 1 10 2 8 14 3 8 14 3 8 6 3 4
1 14 1 2 8 10 0 8 14 3 8 10 2 12 9 4
5 9 2 12 3 8 6 3 8 14 3 10 12 3 6 5
5 3 12 3 12 1 8 14 3 8 14 9 6 11 10 4
5 9 2 12 5 5 5 9 12 3 12 3 10 10 12 5
1 2 8 2 4 5 5 3 2 12 5 11 10 12 3 4
1 10 2 10 6 3 4 9 10 0 6 11 8 2 10 4
5 13 9 10 8 14 3 2 10 6 9 10 6 11 10 4
5 5 5 13 7 9 12 9 10 10 2 8 8 10 10 4
5 1 6 1 10 6 5 3 10 10 8 6 3 12 13 5
5 3 10 6 13 13 5 13 13 9 4 13 13 3 4 5
5 9 10 10 2 0 0 0 0 6 7 3 2 12 1 6
7 3 10 10 10 6 7 7 7 11 10 10 10 2 2 14