9 14 9 10 10 10 8 12 
1 10 4 13 9 10 6 5 
5 11 6 3 4 9 10 4 
3 12 13 9 4 3 12 5 
13 1 6 3 6 9 6 5 
1 6 9 12 9 6 9 6 
1 12 5 5 3 12 3 12 
7 3 6 3 10 6 11 6 