9 12 9 10 10 10 10 10 8 8 10 10 10 10 8 12 
5 5 3 12 9 10 10 14 5 1 10 10 10 12 5 5 
5 3 8 6 3 10 10 10 6 5 11 10 10 4 5 5 
5 9 4 9 10 8 10 10 10 2 10 10 10 6 5 5 
5 5 3 0 12 1 10 10 10 10 10 8 12 9 4 5 
5 3 12 5 5 1 10 8 10 10 12 5 5 7 5 5 
1 8 6 5 5 5 9 6 9 12 3 4 1 10 6 5 
5 3 12 5 5 5 5 9 4 3 12 5 3 12 9 4 
5 9 4 5 5 5 5 3 6 9 6 3 12 5 5 5 
5 5 5 3 6 5 3 10 12 3 12 9 6 5 5 5 
5 5 5 11 10 2 10 12 3 12 1 6 9 4 5 5 
5 5 1 10 12 9 12 3 12 3 4 9 6 5 5 5 
3 4 3 14 5 5 3 12 3 8 2 2 10 6 5 5 
9 4 11 10 4 3 12 3 12 3 10 10 10 10 4 5 
5 1 10 10 6 13 3 12 3 10 10 10 10 10 6 5 
7 3 10 10 10 2 10 2 10 10 10 10 10 10 10 6 
