9 10 12 13 9 10 12 9 12 9 8 8 8 8 8 12 
5 13 5 5 1 14 1 6 7 5 5 5 5 5 5 5 
5 5 5 1 6 11 0 10 12 5 5 5 5 5 5 5 
5 5 5 5 9 12 5 9 6 5 5 5 5 5 5 5 
5 5 5 5 5 5 5 1 12 5 5 5 5 5 5 5 
5 5 1 6 7 5 5 5 5 5 5 5 5 5 5 5 
5 5 1 10 12 3 4 7 7 5 5 5 5 5 5 5 
5 1 0 14 3 12 5 9 12 5 5 5 5 5 5 5 
5 5 5 9 12 7 5 3 4 3 2 2 2 2 0 6 
3 4 1 4 1 12 1 12 1 8 10 10 10 10 6 13 
13 5 5 5 5 5 5 3 6 3 8 10 10 10 10 4 
5 5 5 7 7 7 3 10 14 11 2 14 9 8 12 5 
5 5 3 12 9 10 12 11 8 10 8 10 4 7 3 4 
1 2 8 2 6 11 2 10 4 13 7 13 5 13 13 5 
1 10 2 10 10 8 12 9 4 1 12 5 1 4 5 5 
7 11 10 10 10 6 3 6 3 6 3 6 7 7 3 6 
