11 8 12 9 12 9 12 9 12 9 12 9 12 9 12 13 
9 6 3 6 3 6 3 6 3 6 3 6 3 6 3 4 
3 12 11 8 12 9 12 9 12 9 12 9 12 13 9 6 
9 6 9 6 3 6 3 6 3 6 3 6 3 4 3 12 
3 12 3 12 11 8 12 9 12 9 12 13 9 6 9 6 
9 6 9 6 9 6 3 6 3 6 3 4 3 12 3 12 
3 12 3 12 3 12 9 10 10 12 9 6 9 6 9 6 
9 6 9 6 9 6 5 9 12 5 3 12 3 12 3 12 
3 12 3 12 3 12 5 1 6 5 9 6 9 6 9 6 
9 6 9 6 11 2 6 3 10 6 3 12 3 12 3 12 
3 12 1 12 9 12 9 12 9 12 9 6 9 6 9 6 
9 6 7 3 6 3 6 3 6 3 2 14 3 12 3 12 
3 12 9 12 9 12 9 12 9 12 9 12 9 6 9 6 
13 3 6 3 6 3 6 3 6 3 6 3 2 14 3 12 
1 12 9 12 9 12 9 12 9 12 9 12 9 12 9 6 
7 3 6 3 6 3 6 3 6 3 6 3 6 3 2 14 
